XXXXXXXXXXXXXXXXXXXX
XGXGGGGXGGGXGGGGGGGX
XGXGGGGXGGGXGGGGGGGX
XGXGGGGXGGGXGGGGGGGX
XGXGGGGXGGGXXXXXXGGX
XGXGGGGXGGGGGGGGXGGX
XGGGGGGXGGGGGGGGXGGX
XGXGGGGXGGGGGGGGXGGX
XGXGGGGXGGGGGGGGXGGX
XGXGGGGXGGGGGGGGXGGX
XGXGGGGXGGGGGGGGXGGX
XGXGGGGXGGGGGGGGXGGX
XGXGGGGXXXXXXXXGXXXX
XGXGGGGGGGGGGGGGGGGX
XXXXXXXXXXXXXXXXXXXX
